.  .  .  .  .  .  .  .  .  .  .  M  .  .  .  .  dc .  .  .  .  . 
.  .  .  .  .  .  |  dc .  oy o  *  ky kb kr kg o  o  .  .  .  |
.  .  d> db dx .  .  ~< ~~ ~~ ~~ ~~ ~~ ~~ ~~ ~~ ~~ ~~ ~~ ~~ ~~ ~>
.  .  =< == => .  .  .  .  .  .  .  .  dc .  M  .  Ms .  .  Mf | 
.  .  .  .  .  .  .  .  .  _  _  .  .  .  .  .  .  .  .  .  .  . 
.  .  .  .  .  .  .  .  o  o  .  .  Ms .  .  .  .  .  .  .  .  . 
.  dF df *  D  .  .  .  =< => .  .  .  .  .  .  .  .  .  .  .  . 
.  _  _  _  _  dp .  =  .  .  .  .  .  .  |  d> .  .  .  .  .  . 
|  .  dr .  =< == => .  .  M  =o w  w  w  w  =o .  .  ds |  .  . 
=< == == => .  .  .  .  .  .  _  _  _  _  _  _  _  ~< ~~ ~~ ~~ ~~