. . . . . . . . . . . . . . . . . . . . .
. . . . . . . . . . . . . . . . . . . . .
. . . . . . . . . . . . . . . . . . . . .
. . . . . . . . . . . . . . . . . . . . .
. . . . . . . . . . . . . . . . . . . . .
. . . . . . . . . . . . . . . . . . . . .
. . . . . . . . - - . . . . . . . . . . .
. . . . . . . - . . . . . . . . . . . . .
. . . . - - - . . . . . . . . . . . . . .
- - - - . . . . . . - - - . . . . . . . .
. . . . . . . . . . . . . . . . . . . . .

